NO ./textures/north.xpm
SO ./textures/south.xpm
EA ./textures/east.xpm
WE ./textures/west.xpm
F 220,100,0
C 0,0,255

11111111111111111111
10000000000000000001
10111011111111011101
10111010000001011101
10111010111011111101
10000000000000000001
11111111111111111111