NO                 ./test_decals/greystone.xpm
SO test_decals/eagle.xpm
WE test_decals/mossy.xpm
EA test_decals/eagle.xpm
F 220,100,0
C 255,30,0

1111111
1S00001
1111111
    1 1
    111