NO ./test_decals/greystone.xpm
SO test_decals/eagle.xpm
WE test_decals/mossy.xpm
EA test_decals/eagle.xpm
F 220,100,0
C 255,30,0

11111
11001
10N01
11111