NO ./test_decals/greystone.xpm
SO ./test_decals/greystone.xpm
WE test_decals/mossy.xpm
EA test_decals/eagle.xpm
F 255,0,1
C 255,0,0

1111111
1E00001
1111111
    1 1
    111